001wifi.com	name=新浪
031i.com	name=波克城市
031i.net	name=波克城市
04075k2xgr.com	name=快手
100.me	name=叮咚买菜
101nd.cn	name=网龙
10p07v10o5.com	name=快手
126.am	name=网易
126.com	name=网易
126.fm	name=网易
126.net	name=网易
127.com	name=网易
127.net	name=网易
16163.link	name=网易
16163.vip	name=网易
163.com	name=网易
163.fm	name=网易
163adl.com	name=网易
163fen.com	name=网易
163img.com	name=网易
163mail.com	name=网易
163mail.net	name=网易
163yd.cn	name=网易
166.com	name=网易
166.net	name=网易
166cdn.com	name=网易
1766.com	name=波克城市
18.com.cn	name=东方财富
188.com	name=网易
188.net	name=网易
188cdn.com	name=网易
18plan.com	name=盛趣游戏
2010expotv.com	name=央视
2199.com	name=波克城市
21cntx.com	name=网易
2211.com.cn	name=盛趣游戏
239kt.com	name=波克城市
2op9.net	name=三七互娱
3131.com	name=波克城市
321fenx.com	name=网易
3304399.com	name=4399
3304399.net	name=4399
37.com	name=三七互娱
37api.net	name=三七互娱
37game2.com	name=三七互娱
37ops.com	name=三七互娱
37wan.com	name=三七互娱
37wan.net	name=三七互娱
37wangg.com	name=三七互娱
37wangm.com	name=三七互娱
37wanimg.com	name=三七互娱
37wanmm.com	name=三七互娱
37wanyouxi.com	name=三七互娱
37wanyy.cn	name=三七互娱
37wanyy.net	name=三七互娱
3839.com	name=4399
3839apk.com	name=4399
3839app.com	name=4399
3839app.net	name=4399
3839img.com	name=4399
3839pay.com	name=4399
3839pic.com	name=4399
3839vc.com	name=4399
3839video.com	name=4399
39on.com	name=三七互娱
3mtw.com	name=三七互娱
3p4.cn	name=拼多多
3pwg.com	name=三七互娱
3qxy.com	name=三七互娱
3ylm.com	name=三七互娱
4000066666.com	name=快手
4008206666.com	name=携程
408399.com	name=小米
408399.net	name=小米
4399.cn	name=4399
4399.com	name=4399
4399.net	name=4399
4399api.com	name=4399
4399api.net	name=4399
4399biule.com	name=4399
4399dmw.com	name=4399
4399er.com	name=4399
4399hhh.com	name=4399
4399inc.com	name=4399
4399mail.com	name=4399
4399pk.com	name=4399
4399sj.cn	name=4399
4399sj.com	name=4399
4399swf.com	name=4399
4399wanju.com	name=4399
4399youpai.com	name=4399
4399youpai2.com	name=4399
4399youxi.com	name=4399
4399yyy.com	name=4399
456mh.com	name=波克城市
456vs.com	name=波克城市
4a8.cn	name=拼多多
4a9.cn	name=拼多多
4pn.cn	name=拼多多
4qh.cn	name=拼多多
4sender.com	name=新浪
4sender.net	name=新浪
4t7.cn	name=拼多多
5054399.com	name=4399
5054399.net	name=4399
506u5nf5j5.com	name=快手
51sqp.com	name=波克城市
51xiancheng.com	name=新浪
52d5d.com	name=三七互娱
52hxw.com	name=美图
52tt.com	name=TT语音
52tt01.com	name=TT语音
52tt02.com	name=TT语音
52tt03.com	name=TT语音
52ttyuyin.com	name=TT语音
52yitian.com	name=快手
536fg.com	name=波克城市
54qxz.com	name=波克城市
54zjy.com	name=波克城市
567mh.com	name=波克城市
589pd.com	name=波克城市
5dfsd2.com	name=三七互娱
5jli.com	name=三七互娱
5ooq.com	name=三七互娱
5ypy.com	name=三七互娱
5zmp.com	name=三七互娱
60hx.com	name=三七互娱
60ou.com	name=三七互娱
618im.com	name=波克城市
62youapi.com	name=三七互娱
639uv.com	name=波克城市
6711api.com	name=三七互娱
678mh.com	name=波克城市
682dn.com	name=波克城市
6d4d5.com	name=三七互娱
6ght.com	name=三七互娱
6wtx.com	name=三七互娱
71acg.com	name=4399
71acg.net	name=4399
71edge.com	name=爱奇艺
71edge.net	name=爱奇艺
74kf.com	name=波克城市
7dah8.com	name=恺英网络
7g8g.cn	name=新浪
7pd.cn	name=拼多多
816798.net	name=小米
86114.com	name=网龙
8s4.cn	name=拼多多
915pk.com	name=三七互娱
91huo.cn	name=网龙
91images.com	name=网龙
91meitu.com	name=美图
987ht.net	name=波克城市
99.com	name=网龙
993h.com	name=三七互娱
996a.com	name=三七互娱
9lh.cn	name=货拉拉
9nali.com	name=喜马拉雅
大话西游.中国	name=网易
大话西游.cn	name=网易
大话西游.com	name=网易
大话西游.net	name=网易
飞飞.中国	name=网易
飞飞.cn	name=网易
飞飞.com	name=网易
飞飞.net	name=网易
梦幻西游.中国	name=网易
梦幻西游.cn	name=网易
梦幻西游.com	name=网易
梦幻西游.net	name=网易
仙侠2.cn	name=巨人网络
仙侠2.com	name=巨人网络
小米科技有限责任公司.中国	name=小米
携程.com	name=携程
a7q.cn	name=拼多多
acg.tv	name=哔哩哔哩
acgvideo.com	name=哔哩哔哩
acoloo.com	name=搜狐
activity-dy.com	name=抖音
activity-wbsj.com	name=抖音
activitybyte.com	name=抖音
adbkwai.com	name=快手
adkwai.com	name=快手
adl163.com	name=网易
adukwai.com	name=快手
aduspot.com	name=新浪
advuser.com	name=汽车之家
adxmly.com	name=喜马拉雅
aianno.cn	name=爱奇艺
aianno.com	name=爱奇艺
aihst8.com	name=抖音
aiqiyicloud-mgmt.com	name=爱奇艺
aiqiyicloud.com	name=爱奇艺
aiqiyicloud.net	name=爱奇艺
airvidapp.com	name=美图
aleenote.cn	name=小米
aleenote.com	name=小米
alibiji.cn	name=小米
alinotes.cn	name=小米
alipay-corp.com	name=蚂蚁
alipay-eco.com	name=蚂蚁
alipay-inc.com	name=蚂蚁
alipay.com	name=蚂蚁
alipay.com.cn	name=蚂蚁
alipay.net	name=蚂蚁
alipay.net.cn	name=蚂蚁
alipaylog.com	name=蚂蚁
amemv.cn	name=抖音
amemv.com	name=抖音
amemv.net	name=抖音
annunciation.cn	name=巨人网络
annunciation.com.cn	name=巨人网络
antianbaoche.com	name=携程
anyihua.com	name=马上消费
api6711.com	name=三七互娱
appairvid.com	name=美图
appchizi.com	name=新浪
appeeres.com	name=4399
applinzi.com	name=新浪
appsimg.com	name=唯品会
appsina.com	name=新浪
appvipshop.com	name=唯品会
aqawzxeg.com	name=快手
as3f.com	name=三七互娱
athm.cn	name=汽车之家
athmapp.com	name=汽车之家
autoadsense.cn	name=汽车之家
autoadsense.com	name=汽车之家
autoadsense.com.cn	name=汽车之家
autoadsense.net	name=汽车之家
autoaizs.com	name=汽车之家
autogslb.com	name=汽车之家
autohome.com	name=汽车之家
autohome.com.cn	name=汽车之家
autohomegame.cn	name=汽车之家
autohomegame.com	name=汽车之家
autohomegame.com.cn	name=汽车之家
autoimg.cn	name=汽车之家
autoimg.com	name=汽车之家
autoimg.com.cn	name=汽车之家
avgroft.com	name=快手
avpro.cn	name=央视
avpro.com.cn	name=央视
awemeughun.com	name=抖音
awemeuglang.com	name=抖音
awemeugsoul.com	name=抖音
awemeugwave.com	name=抖音
ayeucefm.com	name=快手
b23.tv	name=哔哩哔哩
baikevod.com	name=抖音
baishimeipai.com	name=美图
banksteel.cn	name=钢银
banksteel.com	name=钢银
banksteeldns.com	name=钢银
banksteeltech.com	name=钢银
battleofballs.cn	name=巨人网络
battleofballs.com	name=巨人网络
battleofballs.net	name=巨人网络
bdactivity.com	name=抖音
bdgslb.com	name=抖音
bdispatch.com	name=抖音
bdispatch.net	name=抖音
bdns-boe.com	name=抖音
bdns-boe.net	name=抖音
bdns-test.com	name=抖音
bdns-test.net	name=抖音
bdsagslb.com	name=抖音
bdsagslbtest.com	name=抖音
bdxiguaimg.com	name=抖音
bdxigualive.com	name=抖音
bdxiguastatic.com	name=抖音
bdxiguavod.com	name=抖音
bdzjdsagslb.com	name=抖音
beautyme.cn	name=美图
beckwai.com	name=快手
beckyroom.com	name=贝壳找房
becukwai.com	name=快手
bee3d.cn	name=美图
bee3d.com	name=美图
beikezhaofang.cn	name=贝壳找房
beikezhaofang.com.cn	name=贝壳找房
beikezhaofang.net	name=贝壳找房
beso.com.cn	name=网龙
besousa.com	name=网龙
betastar.cn	name=抖音
bewoo.com	name=贝壳找房
bfcdnbf.com	name=抖音
bfcdnrd.com	name=抖音
bfcdnsc.com	name=抖音
bgskwai.com	name=快手
bhsr.com	name=米哈游
biaoqingwen.com	name=美图
bigfun.cn	name=哔哩哔哩
bili22.cn	name=哔哩哔哩
bili2233.cn	name=哔哩哔哩
bili23.cn	name=哔哩哔哩
bili33.cn	name=哔哩哔哩
biliapi.com	name=哔哩哔哩
biliapi.net	name=哔哩哔哩
bilibili.cc	name=哔哩哔哩
bilibili.co	name=哔哩哔哩
bilibili.com	name=哔哩哔哩
bilibilipay.cn	name=哔哩哔哩
bilibilipay.com	name=哔哩哔哩
bilioss.com	name=哔哩哔哩
bilivideo.cn	name=哔哩哔哩
bilivideo.com	name=哔哩哔哩
bilivideo.net	name=哔哩哔哩
bkby2.com	name=波克城市
bkby2d.com	name=波克城市
bkby3.com	name=波克城市
bkby3d.com	name=波克城市
bkddz.com	name=波克城市
bnb.com.cn	name=盛趣游戏
bnb.com.cn	name=盛趣游戏
bobworld.cn	name=巨人网络
bobworld.net	name=巨人网络
boke.com	name=波克城市
bokeart.cn	name=波克城市
bokeartcenter.cn	name=波克城市
bokeartcenter.com	name=波克城市
bokeby.com	name=波克城市
bokecorp.com	name=波克城市
bokeddz.com	name=波克城市
bokegy.com	name=波克城市
bokemci.com	name=波克城市
boshihui.com	name=看准科技
bossai.com.cn	name=博思软件
bosssoft.com.cn	name=博思软件
bosssoftpc.com	name=博思软件
bosssoftwszgzj.com	name=博思软件
bosssoftxz.com.cn	name=博思软件
bosszhipin.cn	name=看准科技
bosszhipin.com	name=看准科技
bosszhipin.com.cn	name=看准科技
bosszhishu.com	name=看准科技
boxdouyin.com	name=抖音
boxxcam.com	name=美图
bpaykwai.com	name=快手
bsdwz.cn	name=博思软件
bvfcdn.com	name=抖音
bx1k.com	name=4399
bydrqp.com	name=波克城市
bydrqpb.com	name=波克城市
byqpdr.com	name=波克城市
byte-edge.com	name=抖音
byte-gslb.com	name=抖音
byte00.com	name=抖音
byte008.com	name=抖音
byteac.com	name=抖音
byteacct.com	name=抖音
byteactivity.com	name=抖音
byteactivity11.com	name=抖音
byteactivity12.com	name=抖音
byteactivity13.com	name=抖音
byteactivity14.com	name=抖音
byteactivity15.com	name=抖音
byteactivity16.com	name=抖音
byteadverts.com	name=抖音
byteapi.com	name=抖音
bytecdn.cn	name=抖音
bytecdn.com	name=抖音
bytecdn.net	name=抖音
bytecdntp.com	name=抖音
bytecimg.com	name=抖音
byted-edu.com	name=抖音
byted-static.com	name=抖音
byted-ug.com	name=抖音
bytedance.cn	name=抖音
bytedance.com	name=抖音
bytedance.net	name=抖音
bytedance.org	name=抖音
bytedanceapi.com	name=抖音
bytedcdn.com	name=抖音
bytedgames.com	name=抖音
bytedns.com	name=抖音
bytedns.net	name=抖音
bytedns1.com	name=抖音
bytedns2.com	name=抖音
bytedns3.com	name=抖音
bytedns4.com	name=抖音
bytedns5.com	name=抖音
bytedns6.com	name=抖音
bytedns7.com	name=抖音
bytednsdoc.com	name=抖音
bytedsocial.com	name=抖音
bytefae.com	name=抖音
bytefast.net	name=抖音
bytefcdn.com	name=抖音
bytefcdnrd.com	name=抖音
bytegecko.com	name=抖音
bytegeckoext.com	name=抖音
bytegoofy.com	name=抖音
bytegqpo.net	name=抖音
bytegslb.com	name=抖音
byteimg.com	name=抖音
byteimgc.com	name=抖音
bytelb.com	name=抖音
bytelb.net	name=抖音
bytemaimg.com	name=抖音
bytemastatic.com	name=抖音
bytemedi.com	name=抖音
bytenewst.com	name=抖音
byteorg.com	name=抖音
byteorge.com	name=抖音
byteq5k.com	name=抖音
byteq8u.net	name=抖音
bytescm.com	name=抖音
bytesslb.net	name=抖音
bytetcc.com	name=抖音
bytetech.info	name=抖音
bytetos.com	name=抖音
bytetraffic.net	name=抖音
bytevalk.com	name=抖音
c-ctrip.com	name=携程
c1hdjr.com	name=波克城市
caifutong.com.cn	name=东方财富
campfiregames.cn	name=点点互动
campfires.cn	name=巨人网络
carcdn.com	name=汽车之家
carhll.cn	name=货拉拉
carso.cn	name=汽车之家
carso.com.cn	name=汽车之家
cctv.cn	name=央视
cctv.com	name=央视
cctv.com.cn	name=央视
cctvcdn.com	name=央视
cctvcdn.net	name=央视
cctvlib.cn	name=央视
cctvlib.com	name=央视
cctvlib.com.cn	name=央视
cctvlibrary.cn	name=央视
cctvlibrary.com	name=央视
cctvlibrary.com.cn	name=央视
cctvmall.com	name=央视
cctvolympic.cn	name=央视
cctvolympic.com.cn	name=央视
cctvolympics.cn	name=央视
cctvolympics.com.cn	name=央视
cctvpic.com	name=央视
cctvpro.cn	name=央视
cctvpro.com.cn	name=央视
cdndns1.com	name=抖音
cdndns2.com	name=抖音
centurygame.cc	name=点点互动
centurygames.cn	name=点点互动
chegigi.cn	name=货拉拉
chegigi.com	name=货拉拉
chegigi.com.cn	name=货拉拉
chengzijianzhan.cc	name=抖音
chengzijianzhan.cn	name=抖音
chengzijianzhan.com	name=抖音
chengzijianzhan.net	name=抖音
chengzijianzhana.com	name=抖音
chengzijianzhanb.com	name=抖音
cheshanghui.cn	name=汽车之家
cheshanghui.com.cn	name=汽车之家
cheyoupin.cn	name=货拉拉
cheyoupin.com.cn	name=货拉拉
chinaebill.cn	name=博思软件
chinaebill.com	name=博思软件
chinaebill.com.cn	name=博思软件
chinatravel.net	name=携程
chinatvtech.cn	name=央视
chinatvtech.com.cn	name=央视
cidian.com	name=网易
ckroyzazt.com	name=快手
cntv.cn	name=央视
cntv.com.cn	name=央视
cntvwb.cn	name=央视
cookicut.com	name=抖音
corpautohome.com	name=汽车之家
cpqouzgq.com	name=快手
ctrip-it.com	name=携程
ctrip.cn	name=携程
ctrip.com	name=携程
ctrip.com.cn	name=携程
ctrip.net	name=携程
ctripbiz.com	name=携程
ctripcorp.com	name=携程
ctripgslb.cn	name=携程
ctripgslb.com	name=携程
ctripgslb.com.cn	name=携程
ctripgslb.net	name=携程
ctripqa.com	name=携程
ctws.com.cn	name=新浪
cva.com.cn	name=新浪
cyvksemic.com	name=快手
cziowgbgx.com	name=快手
czztgame.com	name=巨人网络
d-ctrip.com	name=携程
d27xex.com	name=波克城市
da156.cn	name=中原大易
da156.com	name=中原大易
da156.net	name=中原大易
daimengqishi.com	name=波克城市
daoyu8.com	name=盛趣游戏
daoyu8.com	name=盛趣游戏
ddcorp.net	name=叮咚买菜
ddfresh.mobi	name=叮咚买菜
ddfresh.net	name=叮咚买菜
ddimg.mobi	name=叮咚买菜
ddlequ.com	name=拼多多
ddmaicai.mobi	name=叮咚买菜
ddmaicai.net	name=叮咚买菜
ddmc-inc.com	name=叮咚买菜
ddmc.mobi	name=叮咚买菜
ddmcsup.com	name=拼多多
dduser.mobi	name=叮咚买菜
ddxq.mobi	name=叮咚买菜
dewu-inner.com	name=得物
dewu-inner.net	name=得物
dewu.co	name=得物
dewu.com	name=得物
dewu.net	name=得物
dewucdn.com	name=得物
dewuhaowu.cn	name=得物
dewuhd.cn	name=得物
dewuhd.com	name=得物
dewuhui.cn	name=得物
dewuhui.com	name=得物
dewumall.com	name=得物
dewus.cn	name=得物
dewuyouhui.cn	name=得物
dewuyouhui.com	name=得物
dfcfs.com	name=东方财富
dfcfw.com	name=东方财富
dflcs.cn	name=东方财富
dflcs.com.cn	name=东方财富
dftzj.cn	name=东方财富
dftzj.com	name=东方财富
dftzj.com.cn	name=东方财富
diandian.info	name=点点互动
diandianinc.com	name=点点互动
dianmiao.cn	name=快手
dianzhangzhipin.com	name=看准科技
didipai.com	name=搜狐
digiloong.com	name=世纪华通
dingdongxiaoqu.com	name=叮咚买菜
dingqibao.cn	name=东方财富
dingqibao.com	name=东方财富
dingqibao.com.cn	name=东方财富
diwork.com	name=用友
diyiyt.com	name=快手
dl-meitu.com	name=美图
dm518.cn	name=搜狐
dmqst.com	name=波克城市
dnssina.com	name=新浪
docuchina.cn	name=央视
douyin.com	name=抖音
douyinact.com	name=抖音
douyinact.net	name=抖音
douyincdn.com	name=抖音
douyinfe.com	name=抖音
douyinliving.com	name=抖音
douyinpic.com	name=抖音
douyinstatic.com	name=抖音
douyinvod.com	name=抖音
douyu.com	name=斗鱼
douyu.tv	name=斗鱼
douyucdn.cn	name=斗鱼
douyucdn2.cn	name=斗鱼
douyuktv.com	name=斗鱼
douyushow.com	name=斗鱼
douyutv.com	name=斗鱼
draftstatic.com	name=抖音
dreamavatar.com	name=美图
druid.vip	name=抖音
dsclouds.cn	name=用友
dsclouds.com	name=用友
du8.ltd	name=得物
duoduotuanzhang.cn	name=拼多多
duoduotuanzhang.com	name=拼多多
duokanbox.com	name=小米
duoshan.com	name=抖音
dw4.co	name=得物
dwhhd.cn	name=得物
dwhhd.com	name=得物
eastmoney.cn	name=东方财富
eastmoney.com	name=东方财富
eastmoney.com.cn	name=东方财富
easytrip.com	name=携程
ec07yxgd11.com	name=快手
eckwai.com	name=快手
ecukwai.com	name=快手
ecuqzszfr.com	name=快手
edgeorgn.com	name=斗鱼
edgesrv.com	name=斗鱼
edu4399.com	name=4399
emcommon.cn	name=东方财富
emhudong.cn	name=东方财富
emxqurtq.com	name=快手
emzhanghu.cn	name=东方财富
esuveozpx.com	name=快手
etiny.cn	name=网易
exmgovhev.com	name=快手
fanuchdf.com	name=拼多多
fdlbeckwai.com	name=快手
fdleckwai.com	name=快手
fedlearner.net	name=抖音
feelgood.cn	name=抖音
felgame.com	name=波克城市
focus.cn	name=搜狐
funnycore.com	name=4399
g89n.com	name=三七互娱
ga-me.com	name=巨人网络
gaeos.net.cn	name=巨人网络
gamehao.cn	name=波克城市
gamehao.com	name=波克城市
gamehao.com.cn	name=波克城市
gamehao.mobi	name=波克城市
gamepk37.com	name=三七互娱
gandabattle.com	name=恺英网络
gangtaihuochepiao.com	name=携程
gc73.cn	name=波克城市
gc73.com	name=波克城市
gc73.com.cn	name=波克城市
gc73.net	name=波克城市
gcaezpxrv.com	name=快手
gcloud.com.cn	name=盛趣游戏
gcloud.com.cn	name=盛趣游戏
genshinimpact.com	name=米哈游
gfeel.com.cn	name=搜狐
giantcdn.com	name=巨人网络
giftatdw.cn	name=得物
giftatdw.com	name=得物
giftattoday.com	name=得物
goodfeel.cn	name=搜狐
gotochina.com	name=携程
gqzxvogde.com	name=快手
growthsharebounce.cn	name=得物
growthsharequestion.cn	name=得物
growthsharetubular.cn	name=得物
gsayizaic.com	name=快手
gskwai.com	name=快手
gslbdns.com	name=抖音
gslbdns.net	name=抖音
guba.com.cn	name=东方财富
guess8.com	name=斗鱼
guguyuyin.com	name=斗鱼
gundambattle.com	name=恺英网络
guojihuochepiao.com	name=携程
guoneihuochepiao.com	name=携程
guoneijiudian.com	name=携程
guoneizuche.com	name=携程
guoping123.com	name=4399
guoshanchedaheng.com	name=波克城市
guoshanchedaheng.net	name=波克城市
gup-games.com	name=巨人网络
gystatic.com	name=钢银
h5ky.cn	name=恺英网络
h5ky.com	name=恺英网络
h5ky.net	name=恺英网络
hafoo.com	name=东方财富
haiwaijiudian.com	name=携程
haiwaiminsukezhan.com	name=携程
hangtiangame.com	name=波克城市
haowu.link	name=网易
hdiua.com	name=恺英网络
hdslb.com	name=哔哩哔哩
hdslb.org	name=哔哩哔哩
hefeng.tv	name=湖南卫视
hefengtv.com	name=湖南卫视
hefengtv.com.cn	name=湖南卫视
hefengtv.tv	name=湖南卫视
hehecam.com	name=美图
hehecamera.com	name=美图
heihei.com	name=小米
hhtravel.com	name=携程
hifun.tv	name=湖南卫视
hifuntv.cn	name=湖南卫视
hifuntv.com	name=湖南卫视
hifuntv.tv	name=湖南卫视
higgssf.com	name=波克城市
highpin.cn	name=智联招聘
highpin.com.cn	name=智联招聘
hitv.com	name=湖南卫视
hixiaoe.com	name=搜狐
hjy1314.com	name=盛趣游戏
hjy1314.com	name=盛趣游戏
hjy1314.net	name=盛趣游戏
hjy1314.net	name=盛趣游戏
hll.net	name=货拉拉
hllw.cn	name=货拉拉
hmjz2.com	name=巨人网络
hnbntv.com	name=湖南卫视
hongmi.cn	name=小米
hotelwholesaler.net	name=携程
hoyowave.com	name=米哈游
hprotect.cn	name=巨人网络
hsclouds.com	name=用友
huahaicang.cn	name=唯品会
huaxiong.com	name=抖音
hubwisdom.cn	name=携程
huihui.cn	name=网易
hunaniptv.com	name=湖南卫视
hunantv.com	name=湖南卫视
huolala-stg1.cn	name=货拉拉
huolala-stg2.cn	name=货拉拉
huolala-stg3.cn	name=货拉拉
huolala-stg4.cn	name=货拉拉
huolala-stg5.cn	name=货拉拉
huolala.cn	name=货拉拉
huolala.co	name=货拉拉
huolala.store	name=货拉拉
huolala.work	name=货拉拉
huoliuliu.cn	name=货拉拉
huoliuliu.com	name=货拉拉
huoliuliu.work	name=货拉拉
huoqibao.cn	name=东方财富
huoqibao.com	name=东方财富
huoqibao.com.cn	name=东方财富
huoshan.com	name=抖音
huoshancdn.com	name=抖音
huoshangroup.com	name=抖音
huoshanimg.com	name=抖音
huoshanlive.com	name=抖音
huoshanparty.com	name=抖音
huoshanstatic.com	name=抖音
huoshante8.com	name=抖音
huoshanvideo.cn	name=抖音
huoshanvideo.net	name=抖音
huoshanvod.com	name=抖音
huoshanxiaoshipin.cn	name=抖音
huoshanxiaoshipin.net	name=抖音
huoshanzhibo.cn	name=抖音
huoshanzhibo.com	name=抖音
huoshanzhibo.net	name=抖音
huoxiaoliu.cn	name=货拉拉
huoxiaoliu.com	name=货拉拉
huoxing.com	name=新浪
hutaojie.com	name=拼多多
huya.com	name=虎牙
hwj.com	name=贝壳找房
hypercachenet.com	name=抖音
i37wan.net	name=三七互娱
i3839.com	name=4399
i52tt.com	name=TT语音
iautohome.cn	name=汽车之家
iautohome.com	name=汽车之家
iautohome.com.cn	name=汽车之家
ibdxiguaimg.com	name=抖音
ibdxigualive.com	name=抖音
ibdxiguastatic.com	name=抖音
ibdxiguavod.com	name=抖音
ibkstore.com	name=爱奇艺
icourse163.cn	name=网易
icourse163.com	name=网易
icourse163.org	name=网易
icourses163.cn	name=网易
icourses163.com	name=网易
icourses163.org	name=网易
icphoto.cn	name=抖音
idouyinliving.com	name=抖音
idouyinpic.com	name=抖音
idouyinstatic.com	name=抖音
idouyinvod.com	name=抖音
iesdouyin.com	name=抖音
iesdouyin.net	name=抖音
ieshuodong.cn	name=抖音
ieshuodong.net	name=抖音
iextwork.com	name=拼多多
ifaa.org.cn	name=蚂蚁
ifunplus.cn	name=点点互动
iheycar.com	name=汽车之家
ihst8.com	name=抖音
ihuoshanimg.com	name=抖音
ihuoshanlive.com	name=抖音
ihuoshanstatic.com	name=抖音
ihuoshanvod.com	name=抖音
ihykb.com	name=4399
ikaola.cn	name=新浪
iklsjxq.com	name=波克城市
iklsjxq2.com	name=波克城市
iksqkmrdi.com	name=快手
ikuaiying.cn	name=快手
ilangqu.cn	name=新浪
ilangqu.com	name=新浪
ilangqu.com.cn	name=新浪
iluckysf.net	name=抖音
imaicai.mobi	name=叮咚买菜
imark.cn	name=新浪
img4399.com	name=4399
imgkwai.com	name=快手
imgo.tv	name=湖南卫视
imotian.com	name=用友
inkwai.com	name=快手
insdier.net	name=看准科技
insiderspy.net	name=看准科技
instantcredit.cn	name=马上消费
instantfinance.cn	name=马上消费
instantmoney.cn	name=马上消费
iotmrvr.com	name=快手
ipanda.cn	name=央视
ipanda.com	name=央视
ipanda.com.cn	name=央视
ipanda.net	name=央视
ipksmtcpk.com	name=快手
iqiyi.cn	name=爱奇艺
iqiyi.com	name=爱奇艺
iqiyiedge.com	name=爱奇艺
iqiyiedge.net	name=爱奇艺
iqiyipic.com	name=爱奇艺
irrwoavec.com	name=快手
ishangtong.com	name=拼多多
itc.cn	name=搜狐
itc.com.cn	name=搜狐
itoutiaoimg.com	name=抖音
itoutiaoliving.com	name=抖音
itoutiaostatic.com	name=抖音
itoutiaovod.com	name=抖音
ivaoqph.com	name=快手
ivrtmqefs.com	name=快手
ixigua.com	name=抖音
ixumorar.com	name=快手
iyoimar.com	name=快手
izuchebao.com	name=携程
jdu88.com	name=恺英网络
jdycf.com	name=恺英网络
jh8k.com	name=三七互娱
jiajiachexian.com	name=汽车之家
jiangbing.cn	name=爱奇艺
jiaqianglian.com	name=看准科技
jiejimajiang.cn	name=波克城市
jiejimajiang.com	name=波克城市
jiejimajiang.com.cn	name=波克城市
jiejimajiang.net	name=波克城市
jiesongjizhan.com	name=携程
jijiagames.com	name=盛趣游戏
jijiagames.com	name=盛趣游戏
jinritoutiao.com	name=抖音
jj.cn	name=竞技世界
jj.com.cn	name=竞技世界
jjbisai.cn	name=竞技世界
jjbisai.com	name=竞技世界
jjbisai.com.cn	name=竞技世界
jjfuwu.cn	name=竞技世界
jjfuwu.com.cn	name=竞技世界
jjgame.mobi	name=竞技世界
jjgame.org	name=竞技世界
jjhudong.cn	name=竞技世界
jjhudong.com	name=竞技世界
jjmatch.cn	name=竞技世界
jjmatch.com	name=竞技世界
jjmatch.com.cn	name=竞技世界
jjmobile.net	name=竞技世界
jjmobile1.cn	name=竞技世界
jjmobile1.com	name=竞技世界
jjmobile1.net	name=竞技世界
jjmobile10.cn	name=竞技世界
jjmobile10.com	name=竞技世界
jjmobile10.net	name=竞技世界
jjmobile11.com	name=竞技世界
jjmobile12.com	name=竞技世界
jjmobile13.com	name=竞技世界
jjmobile14.com	name=竞技世界
jjmobile15.com	name=竞技世界
jjmobile16.com	name=竞技世界
jjmobile17.com	name=竞技世界
jjmobile18.com	name=竞技世界
jjmobile19.com	name=竞技世界
jjmobile2.cn	name=竞技世界
jjmobile2.com	name=竞技世界
jjmobile2.net	name=竞技世界
jjmobile20.com	name=竞技世界
jjmobile3.cn	name=竞技世界
jjmobile3.com	name=竞技世界
jjmobile3.net	name=竞技世界
jjmobile4.cn	name=竞技世界
jjmobile4.com	name=竞技世界
jjmobile4.net	name=竞技世界
jjmobile5.cn	name=竞技世界
jjmobile5.com	name=竞技世界
jjmobile5.net	name=竞技世界
jjmobile6.cn	name=竞技世界
jjmobile6.com	name=竞技世界
jjmobile6.net	name=竞技世界
jjmobile7.cn	name=竞技世界
jjmobile7.com	name=竞技世界
jjmobile7.net	name=竞技世界
jjmobile8.cn	name=竞技世界
jjmobile8.com	name=竞技世界
jjmobile8.net	name=竞技世界
jjmobile9.cn	name=竞技世界
jjmobile9.com	name=竞技世界
jjmobile9.net	name=竞技世界
jjshare.mobi	name=竞技世界
jjweixin.com	name=竞技世界
jjweixin.com.cn	name=竞技世界
jjweixin.net	name=竞技世界
jjweixin.org	name=竞技世界
jjwifi.net	name=竞技世界
jjworld.net.cn	name=竞技世界
jk3a.com	name=三七互娱
joinchitchat.com	name=喜马拉雅
jokecommunity.cn	name=抖音
jokecommunity.com	name=抖音
jokecommunity.net	name=抖音
jryun.net	name=巨人网络
jstti.com	name=抖音
jtamac.com	name=抖音
juequling.com	name=米哈游
jwyjq.com	name=恺英网络
k.sohu	name=搜狐
kada.com	name=网易
kai-ying.com	name=恺英网络
kandian.cn	name=新浪
kandian.com	name=新浪
kandian.net	name=新浪
kandian.tv	name=新浪
kanyouxi.cn	name=新浪
kanyouxi.tv	name=新浪
kanzhun-inc.com	name=看准科技
kanzhun-ltd.com	name=看准科技
kanzhun.com	name=看准科技
ke.com	name=贝壳找房
kemecwfdv.com	name=快手
kesong.co	name=抖音
kewucool.com	name=小米
kingnet.com	name=恺英网络
kingnetdc.com	name=恺英网络
klsjxq.com	name=波克城市
knscq.com	name=恺英网络
knzlcq.com	name=恺英网络
kolbuyer.cn	name=抖音
kortatb.com	name=快手
ksapisrv.com	name=快手
kskwai.com	name=快手
kspays.com	name=快手
kstv.com	name=快手
kuai-ying.cn	name=快手
kuai-ying.com	name=快手
kuai666bj7tu65rkdz82.com	name=快手
kuai666bjeve6ks43qyw4vc8.com	name=快手
kuai666bjs3gsymi6v4h5pz.com	name=快手
kuai666ogv754urmpb4.com	name=快手
kuai666vs5aq9o3ytdgp.com	name=快手
kuaishou.cn	name=快手
kuaishou.com	name=快手
kuaishouapps.com	name=快手
kuaishougroup.com	name=快手
kuaishoupay.com	name=快手
kuaishouzt.cn	name=快手
kuaishouzt.com	name=快手
kuaizhaogong.cn	name=快手
kuaizhaogong.com	name=快手
kwai-group.com	name=快手
kwai.com	name=快手
kwai.net	name=快手
kwai.xyz	name=快手
kwaicdn.com	name=快手
kwaicdnx.com	name=快手
kwaigroup.com	name=快手
kwailala.cn	name=快手
kwailala.com	name=快手
kwailine.com	name=快手
kwaim.com	name=快手
kwaimetapay.com	name=快手
kwaishouapp.cn	name=快手
kwaishouapp.com	name=快手
kwaishouapp.net	name=快手
kwaitalk.cn	name=快手
kwaitalk.com	name=快手
kwaiying.cn	name=快手
kwaiying.com	name=快手
kwaizt.cn	name=快手
kwaizt.com	name=快手
kwimgs.com	name=快手
kyxy777.com	name=恺英网络
kzntv.cn	name=央视
kzntv.com	name=央视
l4h.cn	name=拼多多
l5rdxt.com	name=波克城市
labafang.com	name=货拉拉
laiqukankan.com	name=网易
lalaframework.cn	name=货拉拉
langke.tv	name=东方财富
las-tech.org.cn	name=快手
leadsfields.cn	name=抖音
leadsfields.com	name=抖音
legendxy.com	name=恺英网络
leijun.com	name=小米
lianjia.com	name=贝壳找房
liudj.com	name=网龙
live-voip.com	name=快手
livecdnstatic.com	name=抖音
livechina.cn	name=央视
livechina.com	name=央视
ljstaff.com	name=贝壳找房
ljuri.com	name=贝壳找房
luckysf.net	name=抖音
lvtds.com	name=携程
lvyougouwushangcheng.com	name=携程
ly3dm.com	name=波克城市
lydr3d.com	name=波克城市
lydrh5.com	name=波克城市
lydryx.com	name=波克城市
m.sohu	name=搜狐
m3-cloud.com	name=小米
mail4399.com	name=4399
maileds.com	name=新浪
maimaixiangce.cn	name=拼多多
maimaixiangce.com	name=拼多多
maimaixiangce.net	name=拼多多
mashangfenqi.com	name=马上消费
mashangjinrong.cn	name=马上消费
mashangjinrong.com	name=马上消费
mashangxiaofei.com	name=马上消费
mciowmmvw.com	name=快手
me4399.com	name=4399
mediabase.cn	name=央视
meiba.com	name=美图
meikeclub.cn	name=美图
meikehui.cn	name=美图
meikehui.com.cn	name=美图
meilaoshi.com	name=美图
meipu.cn	name=美图
meipuapp.com	name=美图
meitie.com	name=美图
meitu-int.com	name=美图
meitu-mobile.com	name=美图
meitu.com	name=美图
meitu.net	name=美图
meituan.com	name=美团
meituan.net	name=美团
meitubase.com	name=美图
meitubeauty.com	name=美图
meitubf.com	name=美图
meitubox.com	name=美图
meitucam.com	name=美图
meitucamera.com	name=美图
meitucoffee.com	name=美图
meitudashi.com	name=美图
meitudata.com	name=美图
meituduoduo.com	name=美图
meitufamily.com	name=美图
meitufans.cn	name=美图
meitufans.com	name=美图
meitugif.com	name=美图
meituhezi.com	name=美图
meituhuahua.com	name=美图
meituinside.com	name=美图
meitukankan.com	name=美图
meitukiss.cn	name=美图
meitukiss.com	name=美图
meitukiss.com.cn	name=美图
meitumail.com	name=美图
meitumob.com	name=美图
meitumv.com	name=美图
meitupaipai.com	name=美图
meituphoto.cn	name=美图
meitupic.com	name=美图
meitupingzi.com	name=美图
meituriji.com	name=美图
meiturom.cn	name=美图
meiturom.com	name=美图
meitushop.cn	name=美图
meitushop.com.cn	name=美图
meitushouji.com	name=美图
meitusnap.com	name=美图
meitustat.com	name=美图
meitustatic.com	name=美图
meitustore.com	name=美图
meitutaotao.com	name=美图
meitutg.com	name=美图
meitutietie.com	name=美图
meituxiangji.com	name=美图
meituxiaopu.com	name=美图
meituxiu.com	name=美图
meituxiuxiu.cn	name=美图
meituxiuxiu.com	name=美图
meituxiuxiu.com.cn	name=美图
meituyidong.com	name=美图
meituyun.cn	name=美图
meituyun.com	name=美图
meituyun.com.cn	name=美图
meiui.cn	name=美图
meiui.com.cn	name=美图
meiwpkpu.com	name=快手
meixinl.com	name=美图
meiyan.com	name=美图
meiyanstatic.com	name=美图
meiyin.cn	name=美图
mg3721.com	name=恺英网络
mgslb.cn	name=小米
mgslb.com	name=小米
mgslb.net	name=小米
mgslb.org	name=小米
mgtv.com	name=湖南卫视
mhystatic.com	name=米哈游
mi-cache.com	name=小米
mi-cdn.com	name=小米
mi-customer.com	name=小米
mi-idc.com	name=小米
mi-img.com	name=小米
mi-img1.com	name=小米
mi-img2.com	name=小米
mi-img3.com	name=小米
mi-img4.com	name=小米
mi-img5.com	name=小米
mi-static.com	name=小米
mi.中国	name=小米
mi.cn	name=小米
mi.com	name=小米
mi0.cc	name=小米
micoce.com.cn	name=小米
micode.cn	name=小米
micode.com.cn	name=小米
micode.net	name=小米
mifile.cn	name=小米
mifx721.com	name=恺英网络
mihayo.com	name=米哈游
mihoyo.com	name=米哈游
mihoyocg.com	name=米哈游
mihoyocloud.com	name=米哈游
mihoyogift.com	name=米哈游
mihoyomall.com	name=米哈游
mij.cc	name=小米
mikge.com	name=小米
miliao.com	name=小米
milliant.com	name=小米
mingxigu.com	name=新浪
mioffice.cn	name=小米
mios.cn	name=小米
mios.com.cn	name=小米
miraclevision.com	name=美图
miredian.com	name=小米
miren.cn	name=小米
mitalk.com	name=小米
mitvos.com	name=小米
mitvos.net	name=小米
miui.cn	name=小米
miui.com	name=小米
miwifi.com	name=小米
mixinshe.com	name=小米
miyoushe.com	name=米哈游
miyun.com	name=小米
mlydr.com	name=波克城市
mmimimia.com	name=拼多多
mobgroupbuy.com	name=拼多多
mobileztgame.com	name=巨人网络
moonlightcam.com	name=美图
moonlightcamera.com	name=美图
moremorep.com	name=拼多多
moremorepin.com	name=拼多多
mosdns.cn	name=美团
mosdns.com	name=美团
mosdns.net	name=美团
mosmss.com	name=美团
mshareservices.com	name=美图
msstatic.com	name=虎牙
msxf.com	name=马上消费
msxfcloud.com	name=马上消费
mtadvert.com	name=美图
mtfamily.cn	name=美图
mtlabai.com	name=美图
mtmos.com	name=美团
mtmss.com	name=美团
mtmssdn.com	name=美团
mtmssdn0.com	name=美团
mtmssup.com	name=美团
mtmssup0.com	name=美团
mtshare.cn	name=美图
mulightapp.com	name=快手
muyecs.com	name=波克城市
mvmaster.com	name=快手
my37wan.com	name=三七互娱
my4399.com	name=4399
my62you.com	name=三七互娱
my95k.com	name=三七互娱
myautohome.cn	name=汽车之家
mygc73.com	name=波克城市
myhll.cn	name=货拉拉
myhotelmall.com	name=携程
myimis.com	name=抖音
mysiteres.com	name=4399
mztgame.com	name=巨人网络
n0vadesktop.com	name=米哈游
nd.com.cn	name=网龙
ndptvr.com	name=网龙
nease.net	name=网易
neihancommunity.cn	name=抖音
neihancommunity.com	name=抖音
neihancommunity.net	name=抖音
netease-inc.com	name=网易
netease.com	name=网易
neverforget.com.cn	name=新浪
nextvid.net	name=抖音
ninelie9.com	name=恺英网络
niunaibox.com	name=湖南卫视
niunaios.com	name=湖南卫视
nunaibox.com	name=湖南卫视
nunaios.com	name=湖南卫视
nunaitv.com	name=湖南卫视
nvgnv.com	name=拼多多
nzsiteres.com	name=4399
o2cam.cn	name=美图
o5zyk9vu2d.com	name=快手
oeleads.cn	name=抖音
oeleads.com	name=抖音
olympicchannelchina.cn	name=央视
omgaixm.com	name=快手
ooqspabeu.com	name=快手
oortgslb.com	name=抖音
openbcs.com	name=抖音
openredcloud.com	name=湖南卫视
openve.cn	name=抖音
oqewsqgis.com	name=快手
originalimg.com	name=抖音
originalstatic.com	name=抖音
originalvod.com	name=抖音
originpic.com	name=快手
orwrsehbq.com	name=快手
oskwai.com	name=快手
oskwai.net	name=快手
osqwsf01.com	name=三七互娱
osqwsf02.com	name=三七互娱
osqwsf03.com	name=三七互娱
osqwsf04.com	name=三七互娱
osqwsf05.com	name=三七互娱
osqwsf06.com	name=三七互娱
osqwsf07.com	name=三七互娱
osqwsf08.com	name=三七互娱
osqwsf09.com	name=三七互娱
osqwsf10.com	name=三七互娱
ourgcf.cn	name=巨人网络
ourgcf.com	name=巨人网络
ozmvpbhc.com	name=快手
p24p75149p.com	name=快手
pandarzli.com	name=得物
pandaschool.com	name=网易
paogame.cn	name=新浪
partynow.com	name=美图
pascalswager.cn	name=巨人网络
paykwai.com	name=快手
pddcdn.com	name=拼多多
pddg.net	name=拼多多
pddim.com	name=拼多多
pddpic.com	name=拼多多
pddugc.com	name=拼多多
peijian.com	name=小米
peiwanlu.com	name=虎牙
pengyoudewu.cn	name=得物
pengyoudewu.com	name=得物
pepsimeipai.com	name=美图
piaoeasy.cn	name=用友
piaoeda.com	name=用友
picself.cn	name=新浪
picself.com.cn	name=新浪
pin18pin.com	name=拼多多
pinduoduo.com	name=拼多多
pinduoduo.net	name=拼多多
pinduoduozp.com	name=拼多多
pinshangyin.com	name=拼多多
pkcity.com	name=波克城市
pkcity.net	name=波克城市
pmoremore.com	name=拼多多
pocketcity.com	name=波克城市
poi234.com	name=恺英网络
poizon-inner.com	name=得物
poizon-inner.net	name=得物
poizon-support.com	name=得物
poizon.com	name=得物
poizon.net	name=得物
pomelocamera.com	name=美图
pook.cn	name=波克城市
pook.com	name=波克城市
pook.com.cn	name=波克城市
pook.mobi	name=波克城市
pookauth.cn	name=波克城市
pookauth.com	name=波克城市
pookauth.net	name=波克城市
pookcdn.com	name=波克城市
pookcdn.net	name=波克城市
pookclub.cn	name=波克城市
pookclub.com	name=波克城市
pookclub.com.cn	name=波克城市
pookclub.net	name=波克城市
pookgitlab.com	name=波克城市
pookgy.com	name=波克城市
pookimg.com	name=波克城市
pookimg.net	name=波克城市
pookmci.com	name=波克城市
pookpay.cn	name=波克城市
pookpay.com	name=波克城市
pookpay.net	name=波克城市
pookyx.com	name=波克城市
pookyx.net	name=波克城市
posterlabs.cn	name=美图
posterlabs.com	name=美图
ppkankan01.com	name=抖音
pstatp.com	name=抖音
qiankunt.com	name=波克城市
qichecdn.com	name=汽车之家
qichetech.com	name=汽车之家
qingxuetang.com	name=喜马拉雅
qipai518.cn	name=波克城市
qishui.cn	name=抖音
qishui.com	name=抖音
qishui.com.cn	name=抖音
qishuimusic.cn	name=抖音
qishuimusic.com.cn	name=抖音
qiyi.cn	name=爱奇艺
qiyi.com	name=爱奇艺
qiyipic.com	name=爱奇艺
qorxcgdmo.com	name=快手
qpbydr.com	name=波克城市
qq163.com	name=4399
qq163.net	name=4399
qqcrvpv.com	name=快手
quwangroup.cn	name=TT语音
quwangroup.com	name=TT语音
qvatar.cn	name=TT语音
qy.com	name=爱奇艺
qy.net	name=爱奇艺
qzzumogie.com	name=快手
rawpic.cn	name=快手
roxoptfim.com	name=快手
rrtoibg.com	name=快手
ruipai.com	name=美图
rxykamto.com	name=快手
saebbs.com	name=新浪
saechizi.com	name=新浪
saelinzi.com	name=新浪
saelinzi0.com	name=新浪
saelinzi1.com	name=新浪
saelinzi2.com	name=新浪
saelinzi3.com	name=新浪
saepool.com	name=新浪
safetyimg.com	name=快手
safetykwai.com	name=快手
safetystatic.com	name=快手
safetyvod.com	name=快手
samacn.org.cn	name=东方财富
samasty.com	name=抖音
sankuai.com	name=美团
sc2yun.com	name=新浪
sdg-china.com	name=盛趣游戏
sdg-china.com	name=盛趣游戏
sdgame.com	name=盛趣游戏
sdgame.com	name=盛趣游戏
sdkbus.com	name=盛趣游戏
sdkbus.com	name=盛趣游戏
sdo.com	name=盛趣游戏
sdo.com	name=盛趣游戏
sdoprofile.com	name=盛趣游戏
searchpstatp.com	name=抖音
searchstatic.com	name=抖音
searchtoutiaoimg.com	name=抖音
searchtoutiaolive.com	name=抖音
segiratcv.com	name=快手
selfiecity.com	name=美图
senderline.com	name=新浪
senderline.net	name=新浪
shandagames.com	name=盛趣游戏
shandagames.com	name=盛趣游戏
shanliaoapp.com	name=美图
shengqu.com	name=盛趣游戏
shengqu.com	name=盛趣游戏
shengqugames.com	name=盛趣游戏
shengqugames.com	name=盛趣游戏
shidianguji.com	name=抖音
shimolife.com	name=抖音
shizhuang-inc.com	name=得物
shizhuang-inc.net	name=得物
shuntu.cn	name=携程
simadata.cn	name=新浪
sina.cn	name=新浪
sina.com	name=新浪
sina.com.cn	name=新浪
sina.net	name=新浪
sinaapp.com	name=新浪
sinacdn.com	name=新浪
sinacloud.cn	name=新浪
sinacloud.com	name=新浪
sinacloud.com.cn	name=新浪
sinacloud.net	name=新浪
sinadaxue.cn	name=新浪
sinadaxue.com	name=新浪
sinadaxue.com.cn	name=新浪
sinaedge.cn	name=新浪
sinaedge.com	name=新浪
sinaimg.cn	name=新浪
sinaimg.com	name=新浪
sinaimg.com.cn	name=新浪
sinajs.cn	name=新浪
sinanet.com	name=新浪
sinanode.com	name=新浪
sinas3.com	name=新浪
sinas3.net	name=新浪
sinastorage.cn	name=新浪
sinastorage.com	name=新浪
sinasws.com	name=新浪
sinauda.com	name=新浪
sinaurl.cn	name=新浪
sinopayment.com.cn	name=蚂蚁
sjhuatong.com	name=世纪华通
skyengine.com.cn	name=TT语音
skyengine.net.cn	name=TT语音
slshare.cn	name=美图
slshareservices.com	name=美图
smartagricompetition.com	name=拼多多
smtcdn.com	name=新浪
snapplay.com	name=虎牙
snssdk.com	name=抖音
sohu-inc.com	name=搜狐
sohu.cn	name=搜狐
sohu.com	name=搜狐
sohu.com.cn	name=搜狐
sohu.net	name=搜狐
sohucs.com	name=搜狐
sohumail.com	name=搜狐
soletower.com	name=恺英网络
soletower.net	name=恺英网络
somaiche.cn	name=汽车之家
somaiche.com	name=汽车之家
somaiche.com.cn	name=汽车之家
somaiche.net	name=汽车之家
soumaiche.cn	name=汽车之家
soumaiche.com	name=汽车之家
soumaiche.com.cn	name=汽车之家
soumaiche.net	name=汽车之家
soundconch.com	name=喜马拉雅
spaceparty.cn	name=巨人网络
spozvmfrs.com	name=快手
spsmctztx.com	name=快手
spyinsider.cn	name=看准科技
srgnmsrg.com	name=拼多多
ssrcdn.com	name=快手
ssscdn.com	name=快手
stardustlm.cn	name=看准科技
stardustlm.com	name=看准科技
stardustlm.com.cn	name=看准科技
starrails.com	name=米哈游
suanya.cn	name=携程
suanya.com	name=携程
supercachenet.com	name=抖音
superpopgames.cn	name=巨人网络
superpopgames.com	name=巨人网络
superpopgames.net	name=巨人网络
swq242xc54.com	name=快手
t.cn	name=新浪
tableauxmly.com	name=喜马拉雅
taotian-inc.com	name=淘天
taotian.com	name=淘天
taqsoagt.com	name=快手
tatstm.com	name=美图
tazai.cn	name=湖南卫视
tazai.com	name=湖南卫视
tcl37.com	name=三七互娱
tezqopei.com	name=快手
tfkf666.com	name=恺英网络
theduapp.cn	name=得物
theduapp.com	name=得物
theduapp.com.cn	name=得物
themisweeps.com	name=米哈游
thll.cn	name=货拉拉
tiantianfunds.cn	name=东方财富
tianyuimg.com	name=网龙
tiapi.cn	name=抖音
tiapi.net	name=抖音
tieyou.com	name=携程
tizijie.com	name=拼多多
tksxqrcko.com	name=快手
tlbapm.com	name=抖音
tongtut.com	name=波克城市
toptown.cn	name=携程
toscdn.com	name=抖音
toursbms.com	name=携程
toutiao.com	name=抖音
toutiao11.com	name=抖音
toutiao12.com	name=抖音
toutiao13.com	name=抖音
toutiao14.com	name=抖音
toutiao15.com	name=抖音
toutiaoapi.com	name=抖音
toutiaocdn.cn	name=抖音
toutiaocdn.com	name=抖音
toutiaocdn.net	name=抖音
toutiaocloud.cn	name=抖音
toutiaocloud.com	name=抖音
toutiaocloud.net	name=抖音
toutiaoimg.cn	name=抖音
toutiaoimg.com	name=抖音
toutiaoimg.net	name=抖音
toutiaojisu.com	name=抖音
toutiaolite.com	name=抖音
toutiaolite1.com	name=抖音
toutiaolite2.com	name=抖音
toutiaoliving.com	name=抖音
toutiaonanren.com	name=拼多多
toutiaopage.com	name=抖音
toutiaopic.com	name=抖音
toutiaostatic.com	name=抖音
toutiaovod.com	name=抖音
toutiaowap.cn	name=抖音
toutiaowap.com	name=抖音
toutiaowap.net	name=抖音
tqdigital.com	name=网龙
tripadv.cn	name=携程
tripcdn.cn	name=携程
tripcdn.com	name=携程
ttbyte.cn	name=抖音
ttbyte.com	name=抖音
ttbyte.net	name=抖音
ttjisu.com	name=抖音
ttwebview.com	name=抖音
ttyuyin.com	name=TT语音
tuer123.com	name=4399
tv.sohu	name=搜狐
tvpro.cn	name=央视
tvpro.com.cn	name=央视
twgame.cn	name=新浪
twgame.com.cn	name=新浪
twilighthero.com	name=波克城市
tx163.com	name=网易
u7x.cn	name=拼多多
ucmclx.com	name=波克城市
ufcap.com	name=用友
ufidaspus.com.cn	name=用友
uono4521.com	name=恺英网络
upeaoktc.com	name=快手
uu820.com	name=恺英网络
uugame.com	name=盛趣游戏
uugame.com	name=盛趣游戏
uxiekafhm.com	name=快手
uxuszdtt.com	name=快手
uyntv.cn	name=央视
uyntv.com	name=央视
uyyikgvpe.com	name=快手
v.sohu	name=搜狐
vanapi.cn	name=货拉拉
vfcdnrd.com	name=抖音
vgslb.com	name=唯品会
vgunxpkt.com	name=拼多多
video-voip.com	name=快手
videoself.cn	name=新浪
vimage1.com	name=唯品会
vimage2.com	name=唯品会
vimage3.com	name=唯品会
vimage4.com	name=唯品会
vip.com	name=唯品会
vipapis.com	name=唯品会
vipappsina.com	name=新浪
vipfashion.com	name=唯品会
vipgslb.com	name=唯品会
vipma.net	name=唯品会
vipshop.com	name=唯品会
vipsinaapp.com	name=新浪
vipstatic.com	name=唯品会
vmoso.cn	name=新浪
vmyamxrbo.com	name=快手
vodkwai.com	name=快手
volcanicengine.com	name=抖音
volcdns-test.com	name=抖音
volcdns-test.net	name=抖音
volleychina.org	name=新浪
vpimg1.com	name=唯品会
vpimg2.com	name=唯品会
vpimg3.com	name=唯品会
vpimg4.com	name=唯品会
vqcouxgpv.com	name=快手
vronline.com	name=恺英网络
vs.cn	name=竞技世界
vzoprymzq.com	name=快手
w2n5cu58rn.com	name=快手
w6r.cn	name=拼多多
wan68.com	name=新浪
wanbuyu.cn	name=波克城市
wanbuyu.com	name=波克城市
wanbuyu.com.cn	name=波克城市
wanbuyu.net	name=波克城市
wandie.com	name=美团
wanwan4399.com	name=4399
wanwork.cn	name=用友
wapone.net	name=新浪
wbimg.cn	name=新浪
wbimg.com	name=新浪
wbimg.com.cn	name=新浪
wcdn.cn	name=新浪
we4399.com	name=4399
webgame163.com	name=4399
weibo.cn	name=新浪
weibo.com	name=新浪
weibo.com.cn	name=新浪
weibo.tv	name=新浪
weibocdn.com	name=新浪
weiboums.com	name=新浪
weicogif.com	name=美图
weipan.cn	name=新浪
weipan.com.cn	name=新浪
weitupian.com	name=美图
weituya.com	name=美图
weizhipin.com	name=看准科技
wetogetherbuy.com	name=拼多多
wexguivq.com	name=快手
whee.com	name=美图
wiwoke.com	name=波克城市
woaihuoshan.com	name=抖音
woaiyt.com	name=快手
wodehaodewu.cn	name=得物
wodeyt.com	name=快手
wohst8.com	name=抖音
womendedw.cn	name=得物
womendedw.com	name=得物
woshihangtianyuan.com	name=波克城市
woziweidao.com	name=竞技世界
wph56.com	name=唯品会
wtturl.cn	name=抖音
wuaijd.com	name=拼多多
www37wan.net	name=三七互娱
wzcimgrk.com	name=快手
x-design.com	name=美图
x5cv.com	name=三七互娱
xalipay.cc	name=蚂蚁
xalipay.co	name=蚂蚁
xcmwqdvc.com	name=快手
xfcap.com	name=用友
xianmobbs.cn	name=波克城市
xianmobbs.com	name=波克城市
xianmoc.com	name=波克城市
xianmoccc.com	name=波克城市
xianxia2.cn	name=巨人网络
xianxia2.com	name=巨人网络
xianxia2.com.cn	name=巨人网络
xianxiashijie.com	name=巨人网络
xiaomi.cn	name=小米
xiaomi.com	name=小米
xiaomi.net	name=小米
xiaomi.org	name=小米
xiaomicorp.cn	name=小米
xiaomicorp.com	name=小米
xiaomicorp.com.cn	name=小米
xiaomicorp.net	name=小米
xiaomidns.cn	name=小米
xiaomidns.com	name=小米
xiaomidns.com.cn	name=小米
xiaomidns.net	name=小米
xiaomiinc.cn	name=小米
xiaomiinc.com	name=小米
xiaomiinc.com.cn	name=小米
xiaomiinc.net	name=小米
xiaomiprint.com	name=小米
xiaomisa.cn	name=小米
xiaomisa.com	name=小米
xiaomisa.net	name=小米
xiaomisa.org	name=小米
xiguaapp.cn	name=抖音
xiguaapp.com	name=抖音
xiguashipin.cn	name=抖音
xiguashipin.net	name=抖音
xiguavideo.cn	name=抖音
xiguavideo.net	name=抖音
xima.tv	name=喜马拉雅
ximalaya.com	name=喜马拉雅
ximalaya.fm	name=喜马拉雅
ximalaya.tv	name=喜马拉雅
xinge.com	name=竞技世界
xiongmaoweilai.com	name=网易
xiuxiustatic.com	name=美图
xlaomi.net	name=小米
xmcdn.com	name=喜马拉雅
xmlywork.com	name=喜马拉雅
xmmtu.com	name=美图
xokaqxxco.com	name=快手
xoriuyvfs.com	name=快手
xsgtvacct.com	name=抖音
xxuzperzq.com	name=快手
xy.com	name=恺英网络
xybygw.com	name=恺英网络
xyddup.com	name=恺英网络
xydevops.com	name=恺英网络
xydhl.com	name=恺英网络
xyimg.net	name=恺英网络
xyjjgw.com	name=恺英网络
xylhgw.com	name=恺英网络
xynbg.com	name=恺英网络
xyniubi.com	name=恺英网络
xynxyy.com	name=恺英网络
xytlgw.com	name=恺英网络
xyxy01.com	name=恺英网络
xyxy02.com	name=恺英网络
xyxy03.com	name=恺英网络
xyxzgw.com	name=恺英网络
xyyx82.com	name=恺英网络
xyyypt.com	name=恺英网络
xyzsq.com	name=恺英网络
y2g.cn	name=拼多多
y4n.cn	name=拼多多
yangfan.org.cn	name=新浪
yangkeduo.com	name=拼多多
ycrpgypxk.com	name=快手
ydstatic.cn	name=网易
ydstatic.com	name=网易
yeah.net	name=网易
yesfp.com	name=用友
ygiurqhcv.com	name=快手
yiqihuihui.com	name=快手
yiqioffice.com	name=快手
yiqixie.com	name=快手
yiqixiegushi.com	name=拼多多
yiwcvtxfz.com	name=快手
yodao.cn	name=网易
yodao.com	name=网易
yodao.com.cn	name=网易
yodao.info	name=网易
yodao.net	name=网易
yodao.org	name=网易
yonbipbox.com	name=用友
yongantravel.cn	name=携程
yonisv.com	name=用友
yonsuite.com	name=用友
yonyou-developer.com	name=用友
yonyou.com	name=用友
yonyou.com.cn	name=用友
yonyouceo.com	name=用友
yonyoucloud.com	name=用友
yonyoumarket.com	name=用友
yonyounccloud.com	name=用友
yonyouup.cn	name=用友
yonyouup.com	name=用友
yonyouup.com.cn	name=用友
yonyouup.net	name=用友
yonyouyc.com	name=用友
yoolauncher.com	name=竞技世界
youba.com	name=4399
youdao.com	name=网易
youdaoads.com	name=网易
yqkk.link	name=网易
yqphh.com	name=拼多多
ytiao.cn	name=网易
ytiny.cn	name=网易
ytongnet.com	name=三七互娱
yueyuanzhiye.com	name=巨人网络
yulunky.com	name=恺英网络
yuncheapp.cn	name=快手
yunshut.com	name=波克城市
yxhhdl.com	name=4399
yximgs.com	name=快手
yxops.com	name=恺英网络
yxzcemet.com	name=快手
yybip.com	name=用友
yyncc.com	name=用友
yyparkcloud.com	name=用友
yyrd.com	name=用友
yyu8c.com	name=用友
yyu9c.com	name=用友
yyuap.com	name=用友
z2u.tv	name=智联招聘
z4u.tv	name=智联招聘
z7xz.com	name=三七互娱
zaimang.net	name=湖南卫视
zhaiba.com	name=东方财富
zhaopin.cn	name=智联招聘
zhaopin.com	name=智联招聘
zhaopin.com.cn	name=智联招聘
zhidaovip.com	name=贝壳找房
zhipin.com	name=看准科技
zhuanzfx.com	name=网易
zhuxiaobang.com	name=抖音
zijieapi.cn	name=抖音
zijieapi.com	name=抖音
zijieapi.net	name=抖音
zijiecdn.cn	name=抖音
zijiecdn.com	name=抖音
zijiecdn.net	name=抖音
zijieimg.cn	name=抖音
zijieimg.com	name=抖音
zijieimg.net	name=抖音
zijietiaodong.com	name=抖音
zijieurl.cn	name=抖音
zijieurl.com	name=抖音
zijieurl.net	name=抖音
zijiewap.cn	name=抖音
zijiewap.com	name=抖音
zijiewap.net	name=抖音
zijinjianguan.cn	name=贝壳找房
zijinjianguan.com	name=贝壳找房
zijinjianguan.net	name=贝壳找房
zilrms.com	name=抖音
ziyrta.com	name=抖音
zjbyte.cn	name=抖音
zjbyte.com	name=抖音
zjbyte.net	name=抖音
zjcdn.com	name=抖音
zjfcdn.com	name=抖音
zjgslb.com	name=抖音
zlzhaopin.com	name=智联招聘
zpapi.com	name=智联招聘
zpin.net.cn	name=智联招聘
zprcxrgr.com	name=快手
zpurl.cn	name=看准科技
zqtcn.com.cn	name=博思软件
zqtpos.com.cn	name=博思软件
zt-g.cn	name=巨人网络
zt-g.com	name=巨人网络
ztgamail.com	name=巨人网络
ztgame.com	name=巨人网络
ztgame.com.cn	name=巨人网络
ztgame.net	name=巨人网络
ztinfoga.com	name=巨人网络
zufangit.cn	name=贝壳找房
zuihi.com	name=三七互娱
zuitu.com	name=美团
