alipay.net.cn	name=蚂蚁
ifaa.org.cn	name=蚂蚁
sinopayment.com.cn	name=蚂蚁
xalipay.cc	name=蚂蚁
alipay.com	name=蚂蚁
alipay.com.cn	name=蚂蚁
alipaylog.com	name=蚂蚁
alipay-eco.com	name=蚂蚁
xalipay.co	name=蚂蚁
alipay-corp.com	name=蚂蚁
alipay-inc.com	name=蚂蚁
alipay.net	name=蚂蚁
taotian-inc.com	name=淘天
taotian.com	name=淘天
mtmssup0.com	name=美团
wandie.com	name=美团
meituan.net	name=美团
sankuai.com	name=美团
mtmss.com	name=美团
mosdns.net	name=美团
mosdns.com	name=美团
zuitu.com	name=美团
mtmos.com	name=美团
mosmss.com	name=美团
mtmssdn.com	name=美团
mtmssup.com	name=美团
mtmssdn0.com	name=美团
mosdns.cn	name=美团
meituan.com	name=美团
4pn.cn	name=拼多多
nvgnv.com	name=拼多多
w6r.cn	name=拼多多
yqphh.com	name=拼多多
maimaixiangce.net	name=拼多多
4t7.cn	name=拼多多
y4n.cn	name=拼多多
smartagricompetition.com	name=拼多多
u7x.cn	name=拼多多
4qh.cn	name=拼多多
ishangtong.com	name=拼多多
vgunxpkt.com	name=拼多多
pddcdn.com	name=拼多多
iextwork.com	name=拼多多
4a9.cn	name=拼多多
a7q.cn	name=拼多多
duoduotuanzhang.cn	name=拼多多
fanuchdf.com	name=拼多多
srgnmsrg.com	name=拼多多
pinduoduozp.com	name=拼多多
pinduoduo.com	name=拼多多
pddugc.com	name=拼多多
maimaixiangce.com	name=拼多多
yangkeduo.com	name=拼多多
pddpic.com	name=拼多多
pinshangyin.com	name=拼多多
tizijie.com	name=拼多多
maimaixiangce.cn	name=拼多多
pin18pin.com	name=拼多多
wuaijd.com	name=拼多多
mobgroupbuy.com	name=拼多多
wetogetherbuy.com	name=拼多多
duoduotuanzhang.com	name=拼多多
mmimimia.com	name=拼多多
3p4.cn	name=拼多多
toutiaonanren.com	name=拼多多
moremorepin.com	name=拼多多
pmoremore.com	name=拼多多
moremorep.com	name=拼多多
ddlequ.com	name=拼多多
y2g.cn	name=拼多多
pddg.net	name=拼多多
pinduoduo.net	name=拼多多
7pd.cn	name=拼多多
pddim.com	name=拼多多
l4h.cn	name=拼多多
ddmcsup.com	name=拼多多
8s4.cn	name=拼多多
4a8.cn	name=拼多多
hutaojie.com	name=拼多多
yiqixiegushi.com	name=拼多多
kuaizhaogong.cn	name=快手
kuaizhaogong.com	name=快手
kuai666bjs3gsymi6v4h5pz.com	name=快手
kuaishou.cn	name=快手
kwai.xyz	name=快手
kstv.com	name=快手
kwai-group.com	name=快手
kuaishougroup.com	name=快手
kuai666bjeve6ks43qyw4vc8.com	name=快手
mvmaster.com	name=快手
kwaiying.com	name=快手
kwaiying.cn	name=快手
kuai-ying.cn	name=快手
kwailala.cn	name=快手
52yitian.com	name=快手
woaiyt.com	name=快手
506u5nf5j5.com	name=快手
yuncheapp.cn	name=快手
kuaishou.com	name=快手
kuai-ying.com	name=快手
ikuaiying.cn	name=快手
rawpic.cn	name=快手
wodeyt.com	name=快手
diyiyt.com	name=快手
kwai.com	name=快手
dianmiao.cn	name=快手
originpic.com	name=快手
kwai.net	name=快手
kuai666bj7tu65rkdz82.com	name=快手
kwailala.com	name=快手
4000066666.com	name=快手
kwaigroup.com	name=快手
ksapisrv.com	name=快手
yiqihuihui.com	name=快手
fdlbeckwai.com	name=快手
qorxcgdmo.com	name=快手
ivrtmqefs.com	name=快手
cyvksemic.com	name=快手
irrwoavec.com	name=快手
xokaqxxco.com	name=快手
ivaoqph.com	name=快手
omgaixm.com	name=快手
iotmrvr.com	name=快手
kwaizt.com	name=快手
oskwai.net	name=快手
kspays.com	name=快手
orwrsehbq.com	name=快手
ygiurqhcv.com	name=快手
roxoptfim.com	name=快手
kwaitalk.com	name=快手
yiqioffice.com	name=快手
aqawzxeg.com	name=快手
upeaoktc.com	name=快手
bpaykwai.com	name=快手
safetyvod.com	name=快手
safetyimg.com	name=快手
vzoprymzq.com	name=快手
qqcrvpv.com	name=快手
kuaishouzt.com	name=快手
live-voip.com	name=快手
xcmwqdvc.com	name=快手
wexguivq.com	name=快手
kuaishouapps.com	name=快手
adkwai.com	name=快手
fdleckwai.com	name=快手
imgkwai.com	name=快手
safetystatic.com	name=快手
oqewsqgis.com	name=快手
mciowmmvw.com	name=快手
iksqkmrdi.com	name=快手
ooqspabeu.com	name=快手
vqcouxgpv.com	name=快手
ecuqzszfr.com	name=快手
uxiekafhm.com	name=快手
kuai666vs5aq9o3ytdgp.com	name=快手
kortatb.com	name=快手
eckwai.com	name=快手
kwaimetapay.com	name=快手
emxqurtq.com	name=快手
adbkwai.com	name=快手
vodkwai.com	name=快手
ipksmtcpk.com	name=快手
esuveozpx.com	name=快手
segiratcv.com	name=快手
exmgovhev.com	name=快手
kwaicdn.com	name=快手
w2n5cu58rn.com	name=快手
yximgs.com	name=快手
oskwai.com	name=快手
gskwai.com	name=快手
kskwai.com	name=快手
uxuszdtt.com	name=快手
kwaim.com	name=快手
ecukwai.com	name=快手
safetykwai.com	name=快手
gsayizaic.com	name=快手
cziowgbgx.com	name=快手
kuai666ogv754urmpb4.com	name=快手
ssrcdn.com	name=快手
las-tech.org.cn	name=快手
kwaishouapp.com	name=快手
kwaitalk.cn	name=快手
o5zyk9vu2d.com	name=快手
yxzcemet.com	name=快手
meiwpkpu.com	name=快手
inkwai.com	name=快手
beckwai.com	name=快手
ycrpgypxk.com	name=快手
gcaezpxrv.com	name=快手
avgroft.com	name=快手
kuaishouzt.cn	name=快手
ayeucefm.com	name=快手
yiqixie.com	name=快手
ixumorar.com	name=快手
cpqouzgq.com	name=快手
bgskwai.com	name=快手
gqzxvogde.com	name=快手
yiwcvtxfz.com	name=快手
tksxqrcko.com	name=快手
kuaishoupay.com	name=快手
ssscdn.com	name=快手
ec07yxgd11.com	name=快手
rxykamto.com	name=快手
mulightapp.com	name=快手
wzcimgrk.com	name=快手
paykwai.com	name=快手
ckroyzazt.com	name=快手
rrtoibg.com	name=快手
kwaizt.cn	name=快手
video-voip.com	name=快手
zprcxrgr.com	name=快手
tezqopei.com	name=快手
taqsoagt.com	name=快手
becukwai.com	name=快手
adukwai.com	name=快手
spsmctztx.com	name=快手
vmyamxrbo.com	name=快手
kemecwfdv.com	name=快手
kwaishouapp.net	name=快手
kwaishouapp.cn	name=快手
iyoimar.com	name=快手
p24p75149p.com	name=快手
ozmvpbhc.com	name=快手
kwimgs.com	name=快手
kwaicdnx.com	name=快手
04075k2xgr.com	name=快手
kwailine.com	name=快手
119.167.216.0	name=快手
uyyikgvpe.com	name=快手
xoriuyvfs.com	name=快手
qzzumogie.com	name=快手
spozvmfrs.com	name=快手
xxuzperzq.com	name=快手
10p07v10o5.com	name=快手
swq242xc54.com	name=快手
ihuoshanvod.com	name=抖音
ppkankan01.com	name=抖音
douyinfe.com	name=抖音
huoshanzhibo.com	name=抖音
huoshanzhibo.cn	name=抖音
cookicut.com	name=抖音
qishuimusic.cn	name=抖音
huoshante8.com	name=抖音
wohst8.com	name=抖音
huoshangroup.com	name=抖音
amemv.net	name=抖音
amemv.cn	name=抖音
ihuoshanstatic.com	name=抖音
activity-wbsj.com	name=抖音
huoshanxiaoshipin.net	name=抖音
douyinact.net	name=抖音
huoshan.com	name=抖音
huoshanxiaoshipin.cn	name=抖音
idouyinvod.com	name=抖音
qishuimusic.com.cn	name=抖音
duoshan.com	name=抖音
luckysf.net	name=抖音
awemeuglang.com	name=抖音
kesong.co	name=抖音
woaihuoshan.com	name=抖音
aihst8.com	name=抖音
ihst8.com	name=抖音
huoshanparty.com	name=抖音
idouyinliving.com	name=抖音
idouyinstatic.com	name=抖音
douyinliving.com	name=抖音
amemv.com	name=抖音
ihuoshanimg.com	name=抖音
huoshanimg.com	name=抖音
supercachenet.com	name=抖音
kolbuyer.cn	name=抖音
ieshuodong.net	name=抖音
huoshanvideo.cn	name=抖音
douyinvod.com	name=抖音
idouyinpic.com	name=抖音
huoshanvod.com	name=抖音
douyinact.com	name=抖音
qishui.com.cn	name=抖音
douyin.com	name=抖音
betastar.cn	name=抖音
huoshanzhibo.net	name=抖音
qishui.cn	name=抖音
nextvid.net	name=抖音
huoshanlive.com	name=抖音
douyinstatic.com	name=抖音
awemeughun.com	name=抖音
ieshuodong.cn	name=抖音
huoshanvideo.net	name=抖音
douyinpic.com	name=抖音
huoshanstatic.com	name=抖音
ihuoshanlive.com	name=抖音
awemeugsoul.com	name=抖音
boxdouyin.com	name=抖音
iluckysf.net	name=抖音
awemeugwave.com	name=抖音
qishui.com	name=抖音
iesdouyin.com	name=抖音
douyincdn.com	name=抖音
iesdouyin.net	name=抖音
bytemastatic.com	name=抖音
toutiaocloud.net	name=抖音
searchpstatp.com	name=抖音
bdispatch.net	name=抖音
ttbyte.com	name=抖音
zjbyte.net	name=抖音
zijieurl.cn	name=抖音
zijieurl.net	name=抖音
zijiewap.com	name=抖音
zilrms.com	name=抖音
jtamac.com	name=抖音
jstti.com	name=抖音
toutiaojisu.com	name=抖音
toutiao.com	name=抖音
toutiao15.com	name=抖音
snssdk.com	name=抖音
xiguavideo.cn	name=抖音
bdxiguastatic.com	name=抖音
itoutiaoimg.com	name=抖音
itoutiaovod.com	name=抖音
byte008.com	name=抖音
zijietiaodong.com	name=抖音
bytedgames.com	name=抖音
byteacct.com	name=抖音
bytescm.com	name=抖音
bytecdntp.com	name=抖音
bytemaimg.com	name=抖音
bfcdnrd.com	name=抖音
openve.cn	name=抖音
byte00.com	name=抖音
bytecimg.com	name=抖音
byted-edu.com	name=抖音
bytenewst.com	name=抖音
bytevalk.com	name=抖音
searchtoutiaolive.com	name=抖音
shidianguji.com	name=抖音
gslbdns.com	name=抖音
bytefcdnrd.com	name=抖音
bytedns6.com	name=抖音
bdsagslb.com	name=抖音
bdsagslbtest.com	name=抖音
114.246.10.65	name=抖音
byteactivity.com	name=抖音
activitybyte.com	name=抖音
byteac.com	name=抖音
xiguaapp.com	name=抖音
originalstatic.com	name=抖音
toutiaovod.com	name=抖音
bytegslb.com	name=抖音
byteactivity14.com	name=抖音
zijieapi.net	name=抖音
bytemedi.com	name=抖音
bytedcdn.com	name=抖音
bytednsdoc.com	name=抖音
bytelb.com	name=抖音
volcanicengine.com	name=抖音
bdns-boe.net	name=抖音
jinritoutiao.com	name=抖音
volcdns-test.com	name=抖音
myimis.com	name=抖音
hypercachenet.com	name=抖音
toutiaoimg.net	name=抖音
toutiaoimg.cn	name=抖音
zijiecdn.net	name=抖音
zijieimg.net	name=抖音
toutiaocdn.net	name=抖音
jokecommunity.net	name=抖音
jokecommunity.cn	name=抖音
ixigua.com	name=抖音
zjgslb.com	name=抖音
bdxiguaimg.com	name=抖音
ibdxigualive.com	name=抖音
toutiaoliving.com	name=抖音
bytedance.com	name=抖音
toutiaopage.com	name=抖音
byteapi.com	name=抖音
toutiaocloud.cn	name=抖音
bytefast.net	name=抖音
bytedns7.com	name=抖音
ttbyte.net	name=抖音
zjbyte.com	name=抖音
zjbyte.cn	name=抖音
toutiaowap.com	name=抖音
toutiaowap.cn	name=抖音
zijiewap.cn	name=抖音
byteimg.com	name=抖音
samasty.com	name=抖音
ttjisu.com	name=抖音
toutiao12.com	name=抖音
toutiao13.com	name=抖音
xiguashipin.cn	name=抖音
bdxigualive.com	name=抖音
toutiaostatic.com	name=抖音
bytedns.com	name=抖音
zjfcdn.com	name=抖音
byteactivity16.com	name=抖音
bytegoofy.com	name=抖音
bytecdn.net	name=抖音
fedlearner.net	name=抖音
bytetraffic.net	name=抖音
searchtoutiaoimg.com	name=抖音
bvfcdn.com	name=抖音
bfcdnbf.com	name=抖音
bdns-test.net	name=抖音
volcdns-test.net	name=抖音
bytedns5.com	name=抖音
wtturl.cn	name=抖音
xiguaapp.cn	name=抖音
cdndns2.com	name=抖音
bytedsocial.com	name=抖音
bytefae.com	name=抖音
bytegecko.com	name=抖音
byteorge.com	name=抖音
livecdnstatic.com	name=抖音
xsgtvacct.com	name=抖音
bdns-boe.com	name=抖音
gslbdns.net	name=抖音
bytedns4.com	name=抖音
bytedns1.com	name=抖音
bdgslb.com	name=抖音
bdxiguavod.com	name=抖音
itoutiaostatic.com	name=抖音
byteq5k.com	name=抖音
bytedns.net	name=抖音
byted-static.com	name=抖音
bytetcc.com	name=抖音
tiapi.cn	name=抖音
searchstatic.com	name=抖音
bytetech.info	name=抖音
bdzjdsagslb.com	name=抖音
zijiecdn.cn	name=抖音
zijieimg.com	name=抖音
jokecommunity.com	name=抖音
neihancommunity.com	name=抖音
neihancommunity.net	name=抖音
bytedanceapi.com	name=抖音
bytedns2.com	name=抖音
originalimg.com	name=抖音
bytedance.net	name=抖音
bytedance.cn	name=抖音
bytedance.org	name=抖音
byteactivity15.com	name=抖音
bytecdn.cn	name=抖音
tiapi.net	name=抖音
draftstatic.com	name=抖音
toutiaocloud.com	name=抖音
bytelb.net	name=抖音
ttbyte.cn	name=抖音
zijieurl.com	name=抖音
toutiaowap.net	name=抖音
zijiewap.net	name=抖音
ziyrta.com	name=抖音
toutiao11.com	name=抖音
toutiao14.com	name=抖音
bytefcdn.com	name=抖音
ibdxiguaimg.com	name=抖音
ibdxiguastatic.com	name=抖音
byte-edge.com	name=抖音
byteq8u.net	name=抖音
zijieapi.com	name=抖音
byteorg.com	name=抖音
baikevod.com	name=抖音
openbcs.com	name=抖音
toutiaopic.com	name=抖音
toutiaocdn.cn	name=抖音
toutiaolite.com	name=抖音
toutiaolite1.com	name=抖音
toutiaolite2.com	name=抖音
toscdn.com	name=抖音
huoshancdn.com	name=抖音
zjcdn.com	name=抖音
xiguashipin.net	name=抖音
cdndns1.com	name=抖音
bytecdn.com	name=抖音
bytegeckoext.com	name=抖音
bdispatch.com	name=抖音
activity-dy.com	name=抖音
bytedns3.com	name=抖音
bytesslb.net	name=抖音
bdactivity.com	name=抖音
xiguavideo.net	name=抖音
icphoto.cn	name=抖音
toutiaoapi.com	name=抖音
ibdxiguavod.com	name=抖音
ttwebview.com	name=抖音
byteactivity11.com	name=抖音
byteactivity13.com	name=抖音
zijieapi.cn	name=抖音
byteadverts.com	name=抖音
byteimgc.com	name=抖音
tlbapm.com	name=抖音
bfcdnsc.com	name=抖音
vfcdnrd.com	name=抖音
druid.vip	name=抖音
bdns-test.com	name=抖音
toutiaocdn.com	name=抖音
toutiaoimg.com	name=抖音
zijiecdn.com	name=抖音
zijieimg.cn	name=抖音
neihancommunity.cn	name=抖音
oortgslb.com	name=抖音
pstatp.com	name=抖音
huaxiong.com	name=抖音
originalvod.com	name=抖音
itoutiaoliving.com	name=抖音
byte-gslb.com	name=抖音
byteactivity12.com	name=抖音
bytegqpo.net	name=抖音
byted-ug.com	name=抖音
bytetos.com	name=抖音
oeleads.cn	name=抖音
oeleads.com	name=抖音
chengzijianzhanb.com	name=抖音
zhuxiaobang.com	name=抖音
chengzijianzhan.net	name=抖音
chengzijianzhan.cn	name=抖音
leadsfields.com	name=抖音
feelgood.cn	name=抖音
chengzijianzhan.cc	name=抖音
chengzijianzhan.com	name=抖音
shimolife.com	name=抖音
leadsfields.cn	name=抖音
chengzijianzhana.com	name=抖音
166.net	name=网易
163.com	name=网易
大话西游.net	name=网易
163fen.com	name=网易
166cdn.com	name=网易
126.am	name=网易
飞飞.net	name=网易
163adl.com	name=网易
163mail.net	name=网易
127.net	name=网易
netease-inc.com	name=网易
188cdn.com	name=网易
tx163.com	name=网易
126.com	name=网易
飞飞.com	name=网易
飞飞.cn	name=网易
梦幻西游.com	name=网易
163img.com	name=网易
大话西游.中国	name=网易
icourses163.cn	name=网易
icourse163.cn	name=网易
yqkk.link	name=网易
大话西游.cn	name=网易
梦幻西游.中国	name=网易
icourse163.com	name=网易
adl163.com	name=网易
21cntx.com	name=网易
126.net	name=网易
梦幻西游.cn	name=网易
yeah.net	name=网易
laiqukankan.com	name=网易
zhuanzfx.com	name=网易
166.com	name=网易
netease.com	name=网易
飞飞.中国	name=网易
188.com	name=网易
梦幻西游.net	name=网易
icourses163.org	name=网易
icourses163.com	name=网易
haowu.link	name=网易
127.com	name=网易
188.net	name=网易
163mail.com	name=网易
大话西游.com	name=网易
icourse163.org	name=网易
321fenx.com	name=网易
nease.net	name=网易
yodao.net	name=网易
kada.com	name=网易
163yd.cn	name=网易
youdaoads.com	name=网易
yodao.com	name=网易
youdao.com	name=网易
ydstatic.cn	name=网易
yodao.org	name=网易
ytiny.cn	name=网易
ytiao.cn	name=网易
cidian.com	name=网易
etiny.cn	name=网易
yodao.com.cn	name=网易
ydstatic.com	name=网易
yodao.info	name=网易
yodao.cn	name=网易
16163.link	name=网易
163.fm	name=网易
huihui.cn	name=网易
126.fm	name=网易
16163.vip	name=网易
pandaschool.com	name=网易
xiongmaoweilai.com	name=网易
xiaomicorp.cn	name=小米
mi-static.com	name=小米
miredian.com	name=小米
xlaomi.net	name=小米
xiaomiinc.com.cn	name=小米
xiaomiinc.cn	name=小米
xiaomidns.net	name=小米
xiaomi.org	name=小米
duokanbox.com	name=小米
xiaomi.net	name=小米
xiaomicorp.com.cn	name=小米
mi-img1.com	name=小米
aleenote.com	name=小米
hongmi.cn	name=小米
micoce.com.cn	name=小米
xiaomi.cn	name=小米
miren.cn	name=小米
mikge.com	name=小米
mioffice.cn	name=小米
58.220.59.2	name=小米
小米.中国	name=小米
heihei.com	name=小米
mi.中国	name=小米
mi.com	name=小米
peijian.com	name=小米
408399.com	name=小米
mixinshe.com	name=小米
xiaomicorp.com	name=小米
mi-img5.com	name=小米
micode.net	name=小米
xiaomiinc.com	name=小米
xiaomidns.com	name=小米
kewucool.com	name=小米
mgslb.cn	name=小米
mios.cn	name=小米
mios.com.cn	name=小米
leijun.com	name=小米
mi-img2.com	name=小米
mifile.cn	name=小米
58.220.58.152	name=小米
mij.cc	name=小米
xiaomisa.org	name=小米
mgslb.org	name=小米
m3-cloud.com	name=小米
miui.com	name=小米
xiaomisa.com	name=小米
mgslb.com	name=小米
mi-cdn.com	name=小米
aleenote.cn	name=小米
alinotes.cn	name=小米
alibiji.cn	name=小米
micode.cn	name=小米
408399.net	name=小米
816798.net	name=小米
mi-idc.com	name=小米
micode.com.cn	name=小米
xiaomidns.com.cn	name=小米
xiaomidns.cn	name=小米
miliao.com	name=小米
mitalk.com	name=小米
miwifi.com	name=小米
xiaomisa.cn	name=小米
mi-customer.com	name=小米
milliant.com	name=小米
mi-cache.com	name=小米
xiaomi.com	name=小米
58.220.58.153	name=小米
xiaomiprint.com	name=小米
mitvos.net	name=小米
mitvos.com	name=小米
mi.cn	name=小米
mi-img3.com	name=小米
xiaomicorp.net	name=小米
mi-img.com	name=小米
xiaomisa.net	name=小米
mgslb.net	name=小米
miui.cn	name=小米
mi-img4.com	name=小米
xiaomiinc.net	name=小米
mi0.cc	name=小米
miyun.com	name=小米
ctripqa.com	name=携程
ctripcorp.com	name=携程
d-ctrip.com	name=携程
lvyougouwushangcheng.com	name=携程
ctrip.com.cn	name=携程
gotochina.com	name=携程
ctripgslb.net	name=携程
easytrip.com	name=携程
hubwisdom.cn	name=携程
antianbaoche.com	name=携程
jiesongjizhan.com	name=携程
4008206666.com	name=携程
guoneijiudian.com	name=携程
chinatravel.net	name=携程
hotelwholesaler.net	name=携程
guojihuochepiao.com	name=携程
c-ctrip.com	name=携程
ctrip.com	name=携程
ctripgslb.com	name=携程
ctripgslb.com.cn	name=携程
suanya.cn	name=携程
ctripbiz.com	name=携程
gangtaihuochepiao.com	name=携程
guoneihuochepiao.com	name=携程
lvtds.com	name=携程
toursbms.com	name=携程
shuntu.cn	name=携程
haiwaiminsukezhan.com	name=携程
myhotelmall.com	name=携程
izuchebao.com	name=携程
hhtravel.com	name=携程
ctrip.cn	name=携程
ctrip.net	name=携程
ctripgslb.cn	name=携程
toptown.cn	name=携程
yongantravel.cn	name=携程
tripcdn.com	name=携程
tripcdn.cn	name=携程
haiwaijiudian.com	name=携程
guoneizuche.com	name=携程
携程.com	name=携程
suanya.com	name=携程
ctrip-it.com	name=携程
tripadv.cn	name=携程
tieyou.com	name=携程
beckyroom.com	name=贝壳找房
zhidaovip.com	name=贝壳找房
ke.com	name=贝壳找房
bewoo.com	name=贝壳找房
beikezhaofang.cn	name=贝壳找房
zijinjianguan.com	name=贝壳找房
beikezhaofang.com.cn	name=贝壳找房
lianjia.com	name=贝壳找房
beikezhaofang.net	name=贝壳找房
ljuri.com	name=贝壳找房
zijinjianguan.net	name=贝壳找房
zijinjianguan.cn	name=贝壳找房
zufangit.cn	name=贝壳找房
hwj.com	name=贝壳找房
ljstaff.com	name=贝壳找房
bigfun.cn	name=哔哩哔哩
bilibili.com	name=哔哩哔哩
acg.tv	name=哔哩哔哩
bilioss.com	name=哔哩哔哩
bilibili.co	name=哔哩哔哩
hdslb.com	name=哔哩哔哩
hdslb.org	name=哔哩哔哩
bilivideo.cn	name=哔哩哔哩
bili22.cn	name=哔哩哔哩
bilibilipay.com	name=哔哩哔哩
biliapi.com	name=哔哩哔哩
biliapi.net	name=哔哩哔哩
bili2233.cn	name=哔哩哔哩
bilibili.cc	name=哔哩哔哩
acgvideo.com	name=哔哩哔哩
bilibilipay.cn	name=哔哩哔哩
bilivideo.com	name=哔哩哔哩
bili23.cn	name=哔哩哔哩
bili33.cn	name=哔哩哔哩
b23.tv	name=哔哩哔哩
bilivideo.net	name=哔哩哔哩
mihoyocg.com	name=米哈游
mihoyocloud.com	name=米哈游
starrails.com	name=米哈游
themisweeps.com	name=米哈游
mihoyo.com	name=米哈游
genshinimpact.com	name=米哈游
n0vadesktop.com	name=米哈游
mihoyomall.com	name=米哈游
mihayo.com	name=米哈游
mhystatic.com	name=米哈游
bhsr.com	name=米哈游
juequling.com	name=米哈游
hoyowave.com	name=米哈游
miyoushe.com	name=米哈游
mihoyogift.com	name=米哈游
3131.com	name=波克城市
daimengqishi.com	name=波克城市
pookclub.cn	name=波克城市
tongtut.com	name=波克城市
felgame.com	name=波克城市
jiejimajiang.com	name=波克城市
jiejimajiang.com.cn	name=波克城市
pookauth.net	name=波克城市
lydr3d.com	name=波克城市
xianmoccc.com	name=波克城市
pkcity.net	name=波克城市
d27xex.com	name=波克城市
pookpay.com	name=波克城市
pookyx.com	name=波克城市
bydrqp.com	name=波克城市
guoshanchedaheng.com	name=波克城市
pookmci.com	name=波克城市
pookcdn.net	name=波克城市
ly3dm.com	name=波克城市
qipai518.cn	name=波克城市
byqpdr.com	name=波克城市
74kf.com	name=波克城市
567mh.com	name=波克城市
54zjy.com	name=波克城市
239kt.com	name=波克城市
wanbuyu.com	name=波克城市
wanbuyu.cn	name=波克城市
mlydr.com	name=波克城市
bkby3.com	name=波克城市
guoshanchedaheng.net	name=波克城市
dmqst.com	name=波克城市
wiwoke.com	name=波克城市
bokeartcenter.cn	name=波克城市
456vs.com	name=波克城市
1766.com	name=波克城市
xianmobbs.cn	name=波克城市
xianmobbs.com	name=波克城市
pookclub.com	name=波克城市
pookclub.net	name=波克城市
pookauth.cn	name=波克城市
boke.com	name=波克城市
bokecorp.com	name=波克城市
hangtiangame.com	name=波克城市
gc73.cn	name=波克城市
gc73.com.cn	name=波克城市
gamehao.com.cn	name=波克城市
pookimg.com	name=波克城市
bkddz.com	name=波克城市
bkby3d.com	name=波克城市
jiejimajiang.cn	name=波克城市
klsjxq.com	name=波克城市
bokeart.cn	name=波克城市
ucmclx.com	name=波克城市
pook.com.cn	name=波克城市
qiankunt.com	name=波克城市
pookauth.com	name=波克城市
qpbydr.com	name=波克城市
618im.com	name=波克城市
54qxz.com	name=波克城市
678mh.com	name=波克城市
gc73.net	name=波克城市
639uv.com	name=波克城市
536fg.com	name=波克城市
wanbuyu.net	name=波克城市
2199.com	name=波克城市
pookpay.net	name=波克城市
yunshut.com	name=波克城市
iklsjxq.com	name=波克城市
456mh.com	name=波克城市
987ht.net	name=波克城市
pkcity.com	name=波克城市
bokegy.com	name=波克城市
pookgy.com	name=波克城市
woshihangtianyuan.com	name=波克城市
gc73.com	name=波克城市
gamehao.mobi	name=波克城市
gamehao.com	name=波克城市
pookyx.net	name=波克城市
pook.com	name=波克城市
pook.cn	name=波克城市
lydrh5.com	name=波克城市
bkby2d.com	name=波克城市
muyecs.com	name=波克城市
jiejimajiang.net	name=波克城市
51sqp.com	name=波克城市
c1hdjr.com	name=波克城市
l5rdxt.com	name=波克城市
pocketcity.com	name=波克城市
pookcdn.com	name=波克城市
iklsjxq2.com	name=波克城市
031i.net	name=波克城市
031i.com	name=波克城市
589pd.com	name=波克城市
682dn.com	name=波克城市
wanbuyu.com.cn	name=波克城市
mygc73.com	name=波克城市
pook.mobi	name=波克城市
pookimg.net	name=波克城市
bokeby.com	name=波克城市
bokeddz.com	name=波克城市
bydrqpb.com	name=波克城市
twilighthero.com	name=波克城市
higgssf.com	name=波克城市
bokeartcenter.com	name=波克城市
xianmoc.com	name=波克城市
pookpay.cn	name=波克城市
bkby2.com	name=波克城市
pookclub.com.cn	name=波克城市
bokemci.com	name=波克城市
lydryx.com	name=波克城市
pookgitlab.com	name=波克城市
gamehao.cn	name=波克城市
aianno.com	name=爱奇艺
iqiyi.cn	name=爱奇艺
qiyi.com	name=爱奇艺
qy.net	name=爱奇艺
iqiyi.com	name=爱奇艺
aiqiyicloud-mgmt.com	name=爱奇艺
aianno.cn	name=爱奇艺
jiangbing.cn	name=爱奇艺
qiyipic.com	name=爱奇艺
qy.com	name=爱奇艺
71edge.com	name=爱奇艺
iqiyiedge.net	name=爱奇艺
aiqiyicloud.com	name=爱奇艺
aiqiyicloud.net	name=爱奇艺
ibkstore.com	name=爱奇艺
iqiyipic.com	name=爱奇艺
qiyi.cn	name=爱奇艺
71edge.net	name=爱奇艺
iqiyiedge.com	name=爱奇艺
