akadns.net	name=Akamai
akamai.com	name=Akamai
akamai.net	name=Akamai
akamaiedge.net	name=Akamai
akamaihd.net	name=Akamai
akamaized.net	name=Akamai
alibabacloud.com	name=Alibaba
amazon.com	name=Amazon Web Services (AWS)
amazonaws.com	name=Amazon Web Services (AWS)
ampproject.org	name=Google
appspot.com	name=Google
atlassian.com	name=Statuspage
awsglobalaccelerator.com	name=Amazon Web Services (AWS)
azure.com	name=Microsoft Azure
azureedge.net	name=Microsoft Azure
cdnetworks.com	name=CDNetworks
cloudapp.net	name=Microsoft Azure
cloudflare.com	name=Cloudflare
cloudflare.net	name=Cloudflare
cloudfront.net	name=Amazon Web Services (AWS)
conviva.com	name=Conviva
demdex.net	name=Adobe EM
digitalocean.com	name=DigitalOcean
edgecastcdn.net	name=Edgio
edgecastcdn.net	name=Verizon
edgekey.net	name=Akamai
fastly.com	name=Fastly
fastly.net	name=Fastly
footprint.net	name=Lumen CDN
google.com	name=Google
googleapis.com	name=Google
herokudns.com	name=Heroku
hwcdn.net	name=StackPath
ibm.com	name=IBM
imperva.com	name=Imperva
incapsula.com	name=Imperva
incapsula.com	name=Imperva
leaseweb.com	name=Leaseweb
linode.com	name=Linode
llnwi.net	name=Edgio
netdna.com	name=StackPath
omtrdc.net	name=Adobe Ads
oracle.com	name=Oracle
ovh.com	name=OVHcloud
quantil.com    name=ChinaNetCenter
rackspace.com	name=Rackspace Technology
s-msedge.net	name=Microsoft Azure
stackpath.com	name=StackPath
stackpathcdn.com	name=StackPath
verizondigitalmedia.com	name=Verizon
verizonmedia.com	name=Verizon
zendesk.com	name=Zendesk